WWWWWW
WEEEEW
WWWWEW
WEEEEW
WEWWWW
WEEEGW
WWWWWW

WWWWWW
WEEEEW
WWWWEW
WEEEEW
WEWWWW
WEEEGW
WWWWWW
