WWWWWW
WEEDEW
WEEDEW
WEEDEW
WWWWWW

WWWWWW
WEE_EW
WEE_EW
WEE_EW
WWWWWW

WWWWWW
WBBDGW
WBBRGW
WBBDGW
WWWWWW
